1111111111
1000010001
10C0000001
1000CE0001
1100000011
10P0000001
1111111111
