11111111111111111111111111111111111111111111111111
100000000000000000000000000000000000010000010000E1
10000000000000000000000000000000000001011111111011
100C0000000000000000000000000000000001010000100001
10000000000000000000000000000000000001011110110001
10000000000000000000000000000000000001000000100111
10000000000000000000000000000000000000000000100001
10000000000000000000000000000000000000000000000001
10000000000000000000000000000000000000000000000001
10000000000000000000000000000000000000000000000001
10000000000000000000000000000000000000000000000001
10000000000000000000000000000000000000000000000001
10000000000000000000000000000000000000000000000001
10000000000000000000000000000000000000000000000001
10000000000000000000000000000000000000000000000001
10000000000000000000000000000000000000000000000001
10000000000000000000000000000000000000000000000001
1P000000000000000000000000000000000000000000000001
11111111111111111111111111111111111111111111111111
