11111111111111111111111111111111111
1P0000000001C0000000000000000000001
11111111110111000111111111110001111
1000000000C1C1000010000010000000011
10111111111100001000111010100001011
1010000100C1011111111C0010000000011
10101101010100110100011110000C00011
10101001010110000001000010000000011
10101011010110111111000010000E00011
10101000C10100000001000010000000011
1C101111110101011101000010000000011
1010100000000101C001000010100001011
10001C11111101010101000010000000011
11111111111111111111111111111111111