111111111111111111111111111111111111111111111
100000000000000000000000000000000000000000001
100100101010100010100010010100010010010101001
1000010010010100100010010100010100100010001E1
100000000000000000000000000000000000000C00001
111111111111111111111111111111111111111111111
