1111111111111111
1000000000000001
10P0000C00000E01
1000000000000001
111111111111111
