111111111111111111
10000000E000000001
10CCCCCCCCCCCCCC01
10C1CCCCCCCCCC1C01
10CCCCCCCCCCCCCC01
10CCCCCCCCCCCCCC01
10C1CCCCCCCCCC1C01
10CCCCCCCCCCCCCC01
10000000P000000001
111111111111111111