1111111111111111111111111111111111
100006000000000C00000C0000000000E1
1010010100100000101001004000010101
1010010010101010001001000000010101
1P0000080C00C0000000000200000000C1
1111111111111111111111111111111111