111111111111111111111111111111111
1P0000000001000C00000000000000001
111111111101110001111111110001111
1000000000C1C10000100001000000011
101111111111000010000011016001011
1010000100C1111111111C01000002011
101011010101001101000101000C00011
101010010101100000010001000000011
101010110101101111010001000E00011
10101000C101200000010001000000011
1C1011111101010111010001080000011
1010100000000101C0010001010041011
10001C111111000101010801000000011
111111111111111111111111111111111