11111111
1000CEP1
10000001
11111111
